###################
#......##...#.....#
#......#D.C.#.....#
#......#.#..#.....#
########.#.D#######
#.@......#......E.#
########.##C#######
#......#.##.#.....#
#......#..C.C.....#
#......#D...#.....#
###################