...................
...................
......#############
......#.....C...#E#
#######.###.#####.#
#.@...D...#.......#
###################
...................
...................
...................
...................