...................
...................
...................
.........###.......
##########.#######.
#.@..D....C....#E#.
######.###..####.#.
...#.............##
...#.......D......#
...################
...................