...................
...................
.........##########
.........#........#
###########D#####.#
#.@......#E.C.....#
########.##D#######
.......#....C.....#
.......############
...................
...................