###################
#.................#
#........##########
#........#......E.#
##########C##D#####
#.@...C........#..#
#####D####.##C##..#
#........D....#...#
#.............#...#
#.............#...#
###################