###################
#       #   #     #
#       #   #     #
#       #   #     #
#       #   #     #
#  @    D   C   E #
#       #   #     #
#       #   #     #
#       #   #     #
#       #   #     #
###################