###################
#........#.#......#
#........#C########
#........#.....E..#
##########.D#######
#.@......#..#.....#
########.##C#.....#
#......#.##.#.....#
#......#..C.C.....#
#......#D...#.....#
###################