....#############..
....#...........#..
....#..C.......####
....#..........C.E#
....#..........####
....#...########...
...##...#@#........
...#C.....#........
...#....D.#........
...#......#........
...########........