###################
#....C......#.....#
#....#.####.#######
#....#.C....C.....#
#....######C#####D#
#.@..#.C..D.C.D..E#
#....#.############
#....#.#..........#
#....#.#..........#
#....D.#..........#
###################