###################
#.................#
#.....#############
#.....#.....C.....#
#######.###.#######
#.@...D...#.#####E#
###########.#####.#
#.........#.......#
#.........#########
#.................#
###################