###################
#....#.......#....#
#....#.......#....#
#....#.......#....#
#....#.......#....#
#.@..D.......C..E.#
#....#.......#....#
#....#.......#....#
#....#.......#....#
#....#.......#....#
###################