...................
...................
...................
...................
###################
#.@..D.......C..E.#
###################
...................
...................
...................
...................