###################
#........#.....#..#
#......###.....####
#......#........E.#
########.......####
#.@...D........#..#
#####.##.#D##C##..#
#...#....D....#...#
#...#.........#...#
#...###########...#
###################