###################
#.................#
#.................#
#.................#
#.................#
#.@.............E.#
#.................#
#.................#
#.................#
#.................#
###################